111110000000000000000000000000000000000000000000000000000000000000000000000000000000000000000000000000000000000000000000000000000000000000000000000000000000000000000000000000000000000000000000000000000000111111
111110000000000000000000000000000000000000000000000000000000000000000000000000000000000000000000000000000000000000000000000000000000000000000000000000000000000000000000000000000000000000000000000000000000111111
111110000000000000000000000000000000000000000000000000000000000000000000000000000000000000000000000000000000000000000000000000000000000000000000000000000000000000000000000000000000000000000000000000000000111111
111110000000000000000000000000000000000000000000000000000000000000000000000000000000000000000000000000000000000000000000000000000000000000000000000000000000000000000000000000000000000000000000000000000000111111
111110000000000000000000000000000000000000000000000000000000000000000000000000000000000000000000000000000000000000000000000000000000000000000000000000000000000000000000000000000000000000000000000000000000111111
111110000000000000000000000000000000000000000000000000000000000000000000000000000000000000000000000000000000000000000000000000000000000000000000000000000000000000000000000000000000000000000000000000000000111111
111110000000000000000000000000000000000000000000000000000000000000000000000000000000000000000000000000000000000000000000000000000000000000000000000000000000000000000000000000000000000000000000000000000000111111
111110000000000000000000000000000000000000000000000000000000000000000000000000000000000000000000000000000000000000000000000000000000000000000000000000000000000000000000000000000000000000000000000000000000111111
111110000005000000000000000000000000000000000000000000000000000000000000000000000000000000000000000000000000000000000000000000000000000000000000000000000000000000000000000000000000000000000000000000000000111111
111110090040000000000000000000000000000000000000000000000000000000000000000000000000000000000000000000000000000000000000000000000000000000000000000000000000000000000000000000005000000000000000000000000000111111
111111111111100005000050000000000000000000000000000000000000000000000000000000000000000000000000000000000000000000000000000000000000000000000000000000000000000000000000000000000000000554440000000000000000111111
111111111111100001111100000000000000000000000000000000000000000000000000000000000000000000000000000000000000000000000000000000000000000000000000000000000000000000000000000000000000000111111110000000000000111111
111111111111100000011100000000000000000000000000000000000000000000000000004400000000000000000000000000000000000000000000000000000000000000000000000000000000000000000000000000002200000111111110000500000000111111
111111111111100000000000000000000000000000000000000000000000000000000000111111100000000000000000500000000000000000000000000000000000000000000000000000000000000000000000000000000000000000000000000000000000111111
111111111111100000000000000540000000000000050005000000000000000000000000111111100000005000000000000000005555000000000000000000000000000000000000000000000000000000000000001220000000000000000000000000000000111111
111111111111100000000000001111000000000000111111100000000000000000000051111111100000000004440000000004005555040000000000000000000000000000000000000000000000000000000000110000000000000000000000000000500000111111
111111111111100000000000001111000000500500000000000000004400004400000111111111100000001111111110000011111111111100005545000000000000000000000000000000000000000000000000100000000000000000000000000000000000111111
111111111111100000000000000000000001111100000000000000111111111111000000000000000000010000000000000011111111111100001111100000000000000000000000000000000000000000000002100000000000000000000000000000000000111111
111111111111100000000000000000000000000000000000000000111111111111000000000000000000110000000000000011111111111100001111100500000000000000000000000000000000000000000210000000000000000000000000000000050000111111
111111111111100000000000000000000000000000000000000000111111111111000000000000000000000000000000000011111111111100000000000000000000005000050000500000005044405555000000000000000000000000000000000000000000111111
111111111111100000000000000000000000000000000000000000000000000000000000000000000000000000000000000011111111111100000000000000544000000200002000020000001111111111100000000000000000000000000000000000000000111111
111111111111100000000000000000000000000000000000000000000000000000000000000000000000000000000000000011111111111100000000000001111111000000000000000000001111111111100000000000000000000000000000000000000000111111
111111111111100000000000000000000000000000000000000000000000000000000000000000000000000000000000000011111111111100000000000001111111000000000000000000001111111111100000000000000000000000000000000000003000111111
111111111111100000000000000000000000000000000000000000000000000000000000000000000000000000000000000011111111111100000000000001111111000000000000000000001111111111100000000000000000000000000000000011111111111111
111111111111100000000000000000000000000000000000000000000000000000000000000000000000000000000000000011111111111100000000000000000000000000000000000000001111111111100000000000000000000000000000000011111111111111
111111111111100000000000000000000000000000000000000000000000000000000000000000000000000000000000000011111111111100000000000000000000000000000000000000000000000000000000000000000000000000000000000011111111111111
111111111111100000000000000000000000000000000000000000000000000000000000000000000000000000000000000011111111111100000000000000000000000000000000000000000000000000000000000000000000000000000000000011111111111111
111111111111100000000000000000000000000000000000000000000000000000000000000000000000000000000000000011111111111100000000000000000000000000000000000000000000000000000000000000000000000000000000000011111111111111
111111111111100000000000000000000000000000000000000000000000000000000000000000000000000000000000000011111111111100000000000000000000000000000000000000000000000000000000000000000000000000000000000011111111111111
111111111111100000000000000000000000000000000000000000000000000000000000000000000000000000000000000011111111111100000000000000000000000000000000000000000000000000000000000000000000000000000000000011111111111111
111111111111100000000000000000000000000000000000000000000000000000000000000000000000000000000000000011111111111100000000000000000000000000000000000000000000000000000000000000000000000000000000000011111111111111
111111111111100000000000000000000000000000000000000000000000000000000000000000000000000000000000000011111111111100000000000000000000000000000000000000000000000000000000000000000000000000000000000011111111111111
111111111111144444444444444444444444444444444444444444444444444444444444444444444444444444444444444411111111111144444444444444444444444444444444444444444444444444444444444444444444444444444444444411111111111111
111111111111111111111111111111111111111111111111111111111111111111111111111111111111111111111111111111111111111111111111111111111111111111111111111111111111111111111111111111111111111111111111111111111111111111
111111111111111111111111111111111111111111111111111111111111111111111111111111111111111111111111111111111111111111111111111111111111111111111111111111111111111111111111111111111111111111111111111111111111111111
111111111111111111111111111111111111111111111111111111111111111111111111111111111111111111111111111111111111111111111111111111111111111111111111111111111111111111111111111111111111111111111111111111111111111111
111111111111111111111111111111111111111111111111111111111111111111111111111111111111111111111111111111111111111111111111111111111111111111111111111111111111111111111111111111111111111111111111111111111111111111
