11110000000000000000000000000000000000000000000000000000000000000000000000000000000000000000000000000000000000000000000000000000000000000000000000000000000000000000000000000000000000000000000000000000000111111
11110000000000000000000000000000000000000000000000000000000000000000000000000000000000000000000000000000000000000000000000000000000000000000000000000000000000000000000000000000000000000000000000000000000111111
11110000000000000000000000000000000000000000000000000000000000000000000000000000000000000000000000000000000000000000000000000000000000000000000000000000000000000000000000000000000000000000000000000000000111111
11110000000000000000000000000000000000000000000000000000000000000000000000000000000000000000000000000000000000000000000000000000000000000000000000000000000000000000000000000000000000000000000000000000000111111
11110000000000000000000000000000000000000000000000000000000000000000000000000000000000000000000000000000000000000000000000000000000000000000000000000000000000000000000000000000000000000000000000000000000111111
11110000000000000000000000000000000000000000000000000000000000000000000000000000000000000000000000000000000000000000000000000000000000000000000000000000000000000000000000000000000000000000000000000000000111111
11110000000000000000000000000000000000000000000000000000000000000000000000000000000000000000000000000000000000000000000000000000000000000000000000000000000000000000000000000000000000000000000000000000000111111
11110000000000000000000000000000000000000000000000000000000000000000000000000000000000000000000000000000000000000000000000000000000000000000000000000000000000000000000000000000000000000000000000000000000111111
11110000005000000000000000000000000000000000000000000000000000000000000000000000000000000000000000000000000000000000000000000000000000000000000000000000000000000000000000000000000000000000000000000000000111111
11110090040000000000000000000000000000000000000000000000000000000000000000000000000000000000000000000000000000000000000000000000000000000000000000000000000000000000000000000000000000000000000000000000000111111
11111111111100000000000000000000000000000000000000000000000000000000000000000000000000000000000000000000000000000000000000000000000000000000000000000000000000000000000000000000000000004440000000000000000111111
11111111111100001111100000000000000000000000000000000000000000000000000000000000000000000000000000000000000000000000000000000000000000000000000000000000000000000000000000000000000000111111110000000000000111111
11111111111100000011100000000000000000000000000000000000000000000000000000400000000000000000000000000000000000000000000000000000000000000000000000000000000000000000000000000002200000111111110000000000000111111
11111111111100000000000000000000000000000000000000000000000000000000000111111100000000000000000000000000000000000000000000000000000000000000000000000000000000000000000000000000000000000000000000000000000111111
11111111111100000000000000000000000000000000000000000000000000000000000111111100000000000000000000000000000000000000000000000000000000000000000000000000000000000000000001220000000000000000000000000000000111111
11111111111100000000000001111000000000000111111100000000000000000000001111111100000000000000000000000000000000000000000000000000000000000000000000000000000000000000000110000000000000000000000000000000000111111
11111111111100000000000001111000000000000000000000000004400004400000111111111100000001111111110000011111111111100000000000000000000000000000000000000000000000000000000100000000000000000000000000000000000111111
11111111111100000000000000000000001111100000000000000111111111111000000000000000000010000000000000011111111111100001111100000000000000000000000000000000000000000000002100000000000000000000000000000000000111111
11111111111100000000000000000000000000000000000000000111111111111000000000000000000110000000000000011111111111100001111100000000000000000000000000000000000000000000210000000000000000000000000000000000000111111
11111111111100000000000000000000000000000000000000000111111111111000000000000000000000000000000000011111111111100000000000000000000000000000000000000000044400000000000000000000000000000000000000000000000111111
11111111111100000000000000000000000000000000000000000000000000000000000000000000000000000000000000011111111111100000000000000044000000200002000020000001111111111100000000000000000000000000000000000000000111111
11111111111100000000000000000000000000000000000000000000000000000000000000000000000000000000000000011111111111100000000000001111111000000000000000000001111111111100000000000000000000000000000000000000000111111
11111111111100000000000000000000000000000000000000000000000000000000000000000000000000000000000000011111111111100000000000001111111000000000000000000001111111111100000000000000000000000000000000000003000111111
11111111111100000000000000000000000000000000000000000000000000000000000000000000000000000000000000011111111111100000000000001111111000000000000000000001111111111100000000000000000000000000000000011111111111111
11111111111100000000000000000000000000000000000000000000000000000000000000000000000000000000000000011111111111100000000000000000000000000000000000000001111111111100000000000000000000000000000000011111111111111
11111111111100000000000000000000000000000000000000000000000000000000000000000000000000000000000000011111111111100000000000000000000000000000000000000000000000000000000000000000000000000000000000011111111111111
11111111111100000000000000000000000000000000000000000000000000000000000000000000000000000000000000011111111111100000000000000000000000000000000000000000000000000000000000000000000000000000000000011111111111111
11111111111100000000000000000000000000000000000000000000000000000000000000000000000000000000000000011111111111100000000000000000000000000000000000000000000000000000000000000000000000000000000000011111111111111
11111111111100000000000000000000000000000000000000000000000000000000000000000000000000000000000000011111111111100000000000000000000000000000000000000000000000000000000000000000000000000000000000011111111111111
11111111111100000000000000000000000000000000000000000000000000000000000000000000000000000000000000011111111111100000000000000000000000000000000000000000000000000000000000000000000000000000000000011111111111111
11111111111100000000000000000000000000000000000000000000000000000000000000000000000000000000000000011111111111100000000000000000000000000000000000000000000000000000000000000000000000000000000000011111111111111
11111111111100000000000000000000000000000000000000000000000000000000000000000000000000000000000000011111111111100000000000000000000000000000000000000000000000000000000000000000000000000000000000011111111111111
11111111111144444444444444444444444444444444444444444444444444444444444444444444444444444444444444411111111111144444444444444444444444444444444444444444444444444444444444444444444444444444444444411111111111111
11111111111111111111111111111111111111111111111111111111111111111111111111111111111111111111111111111111111111111111111111111111111111111111111111111111111111111111111111111111111111111111111111111111111111111
11111111111111111111111111111111111111111111111111111111111111111111111111111111111111111111111111111111111111111111111111111111111111111111111111111111111111111111111111111111111111111111111111111111111111111
11111111111111111111111111111111111111111111111111111111111111111111111111111111111111111111111111111111111111111111111111111111111111111111111111111111111111111111111111111111111111111111111111111111111111111
11111111111111111111111111111111111111111111111111111111111111111111111111111111111111111111111111111111111111111111111111111111111111111111111111111111111111111111111111111111111111111111111111111111111111111
